NO wall.xpm
SO wall.xpm
WE wall.xpm
EA wall.xpm

F 220,100,0
C 225,30,0

        1111111111111111111111111
        1000000000110000000000001
        1011000001110000000000001
        10010000000D0000000000001
111111111011000001110000000000001
10000000001100000111011111D111111
11110111111111011100000010001
11110111111111011101010000001
11000000110101011100000010001111111
100000000000000011000000100011111
10000000000000001101010010001
11000001110101011111011110E001
11110111 1110101 101111010001
11111111 1111111 111111111111