NO textures/wall.xpm
SO textures/wall.xpm
WE textures/wall.xpm
EA textures/wall.xpm

C 80,180,255
F 18,93,72


        1111111111111111111111111
        1000000000110000000000001
        1011000001110000000000001
        10010000000D0000000000001
111111111011000001110000000000001
10000000001100000111011111D111111
11110111111111011100000010001
11110111111111011101010000001
11000000110101011100000010001111111
10000000000000000D000000100001111
1000000000000000110101001000111
11000001110101011111011110N001
11110111 1D10101 101111010001
11111111 1111111 111111111111
