NO textures/wall3.xpm
SO textures/wall2.xpm
WE textures/wall.xpm
EA textures/wall1.xpm

C 80,180,255
F 18,93,72


        1111111111111111111111111
        1000000000110000000000001
        1011000001110000000000001
        1001000000D00000000000001
111111111011000001110000000000001
10000000001100000111011111011111
11110111111111011100011111D111
111101111111110111010001110001
11000000110101011100000D0001111111
10000000000000000D000001100001111
1000000000000000110101001000111
11000001110101011111011110N001
11110111 1D10101 101111010001
11111111 1111111 111111111111
